###########....
#w#...#..D#....
#......k###....
###########....
...............
...............
...............
...............
...............
...............
...............
...............
...............
...............
...............
