######################
#.#######.............
#.k.r.#...............
###.r.D.#.............
#.#######.............
#...#.................
#.s.#.................
#.r.#.................
#.s.#.................
#.r.#.................
#.r.s.#...............
#.#...................
#.#...................
#.r.MMMM.#............
#.HHHHH.#.............
#.#...................
#.#...................
#.s.#.................
#.#...................
#.r.r.r.sssss#.......w
######################
