###############
#......oN.....#
#.HHHHHHMHHHHr#
#r<F......!.H.#
#IHHHHHIIHH.H.#
#.>....o1o!cH.#
#HHHHHHHHHHIHr#
#.c.........Hr#
#.HtH.......H.#
#.HoH...r...H.#
#.HoH.MMMMMqH.#
#.HCHHHHHHH1Hr#
#.8.....urHsHt#
#sZMMMMwMMh.Hd#
###############
