                                                  
                                                  
                                                  
                                                  
                                                  
                                                  
                                                  
                                                  
                                                  
                                                  
                                                  
                         3                        
                              #############       
                              #Lw       ss#       
                              #w         s#       
                              #      O    #       
#################             #           #       
#               #             #           #       
#               #       #######           #       
#               #       #                 #       
#               #       #        ```````` #       
#               #       #        ```````` #       
#       m       #       #        ```````` #       
#               #########                 #       
#                                         #       
#                        <<<<<<           #       
#                        <<<<<<           #       
#                        <<<<<<           #       
#                        <<<<<<           #       
#                        <<<<<<           #       
#                                         #       
#                                        /#       
###########################################       
                                                  
                                                  
                                                  
                                                  
                                                  
