HHHHHHHHHHHHHHHH
H..........H...H
H..........Hd..H
H.....r..r.HHIIH
H............r.H
H..............H
Hr..I..I.....I.H
H..............H
HI.......III...H
H..r...........H
H......r..r....H
HIII...........H
H........IIII..H
H...r..r.......H
H........r.....H
H..III.........H
H.........II...H
Hw.............H
H##############H
H##############H
