HHHHHHHHHHHHHHHHHHHHHHH
H....q...............NH
H2...q...........o....H
H.MM.q.....#########.ZH
H.ff.Ht....#1#8#####.IH
H....H.....#..........H
H....H.....#MMMMMMMMMMH
H..o.H.....###########H
HsMMMH................H
HHHHHH.....#######.###H
H...........!8#8@...CdH
H..........###########H
H.................q...H
Hw................q..8H
HHHH...B.bHHHHHHHHHHHHH
.......................
.......bB..............
.......................
