HHHHHHHHHHHHHHHHH
H...............H
H...............H
H...............H
H..........r..D.H
H...........####H
H...........####H
H..........r####H
H...I#.r....####H
H....#...r..####H
H...r#II...r####H
H....#..II..####H
Hw..f#k....s####H
H###############H
H###############H