H..............H
H..............H
H..............H
H..............H
H..............H
H..............H
H..............H
H..............H
H....rrrr......H
H..............H
H.w........d...H
H######MM######H
HHHHHHHHHHHHHHHH
................
