HHHHHHHHHHHHHHH
H8q........8..H
Hq....8......oH
HIII......HHHHH
H.......8.....H
H..........8..H
H....III......H
H...8.........H
HII....8..III.H
H.8.......8...H
H..........II.H
H8..8......8..H
H.....IIII.HHHH
HHH......8.H8.H
HdCw..8Z...>oFH
H#############H
HHHHHHHHHHHHHHH
