H..............H
H..............H
H..............H
H..............H
H..............H
H..............H
H..............H
H......r.......H
H..............H
H.w.........d..H
H######MM######H
HHHHHHHHHHHHHHHH
................
................
................
