H.......H...............H.....H
H.......H...............H.....H
H.......H...............H.....H
H.......H...............H.....H
H.......H...............H.....H
H.......H...............H.....H
H.......H...............H.....H
H.......H...............H.....H
H.......H.H...........H.H.....H
H.......H.HII.......IIH.H.....H
H.......H.H...........H.H.....H
HHHHHHHHH.HIIII...IIIIH.HHHHHHH
Hd!3@4@3%.>.....w.....<4$2%2$1H
H#############################H
H#############################H
