H............H..H
H............H..H
H............H..H
H............H..H
H............H..H
H............H..H
H............H..H
H...r........H..H
H..Io........Hd.H
H...H.r......HHrH
HII.HI.......H..H
H...H...r.r..H.rH
H..wH..MMMM..r..H
H###############H
.................
