H..............H
H..............H
H..............H
H..r.r...u.....H
H.d....r...r...H
HIIII..........H
H......IIII..r.H
H..............H
H....r..r....IIH
H..r......r....H
H....##......IIH
H.w..##........H
H######MM######H
HHHHHHHHHHHHHHHH
................
