#............u..#
#...............#
#wrrrrrk........#
#######.........#
#...............#
#.....r.........#
#.....r.........#
#.....r.........#
#...............#
#.....ssss......#
#....r2@DM......#
#....hIIII......#
#...............#
#...............#
#...............#
