HHHHHHHHHHHHHHH
H......H.....NH
H......H......H
H......H.....rH
H.....HH.....oH
H....HH...r..IH
HHHHHH.r......H
H...r.....###IH
H..fffff#.###.H
H.r##########.H
H..<....8..!doH
Hh.M.8.8...HHHH
H..H.....8.Hr.H
HwFH8..8...C.1H
H##H##########H
