H.............H
H.............H
H.............H
H.............H
H......r......H
H....r...r....H
H..r.......r..H
H.w.........d.H
HII........IIIH
H.............H
H.............H
H.............H
H.............H
H.............H
H.............H
