H..k...o....c...........ruH
H#.###########.##########IH
H............M.M..#.......H
H.........................H
H.f.............h.#IIII...H
H.................#.......H
H.........................H
HMMMMMMMMM.....c..#.......H
H###########.I.I.I#.......H
H.......#.........#.......H
H.......#.#IIIIIII#r.r.r.rH
H...D...#.#.......#.......H
H..###....#.......#.......H
Hw.......f#..f.f.f#fsfsfsfH
###########################
