H..............H
H..........u...H
H..............H
H.........h....H
H..............H
H..............H
H..h...........H
H...........u..H
H........h.....H
H.w..........d.H
H######MM######H
HHHHHHHHHHHHHHHH
................
................
................
